1111111111111
10010000000C1
10P0011111001
100011E001001
1111111111111