1111111111111
1N010000000C1
10P0011111001
100011E001001
1111111111111